 9, 5, 7, 9, 1, 5, 7, 8, 5, 1, 5, 3, 9, 5, 3,11
 8, 3, 9, 6,12, 5, 5, 6, 9, 6,11,10,10,11,12, 2
10,12, 4, 5, 3, 9, 5, 3,10,13, 2,10,10,10, 9, 6
10, 9, 3,11,10,12, 7,10,10, 9, 6,12, 6, 8, 6,11
14,10,10,12, 4, 5, 5, 2,10,12, 1, 1, 7,10, 9, 2
 9, 6,12, 5, 5, 5, 3,14,12, 3,14,12, 3,12, 6,10
10, 9, 3,13, 5, 3,12, 5, 3, 8, 5, 3,12, 5, 3,10
10,10,12, 3, 9, 6, 9, 5, 6,14, 9, 6, 9, 5, 6,10
10,10, 9, 2,12, 5, 4, 5, 5, 5, 6,11, 8, 5, 5, 6
 8, 6,10,14, 9, 5, 5, 3,13, 5, 1, 2,10, 9, 3,11
12, 7,12, 5, 4, 1, 7,12, 1, 3,14,10,10,10,10,10
 9, 5, 5, 3,13, 6, 9, 3,14,12, 3, 8, 6,10,12, 2
10,13, 3,10, 9, 5, 6,12, 5, 5, 6,12, 3,10, 9, 6
12, 3,12, 4, 6,11, 9, 5, 5, 1, 1, 7,12, 6,12, 3
 9, 6, 9, 3,13, 4, 6, 9, 3,10,12, 1, 5, 5, 7,10
12, 5, 6,12, 5, 5, 5, 6,10,12, 7,12, 5, 5, 5, 6
